{
  "format": "archer-map",
  "version": 5,
  "name": "def1",
  "tilesX": 32,
  "tilesZ": 32,
  "layers": [
    "222222222222222222222222222222222",
    "222222222222222222224422222222222",
    "222222222233222222224422222222222",
    "222222222233222222224422222222222",
    "222222222333222222224422222222222",
    "222222222333222222224422222222222",
    "222222222333222222224422222222222",
    "222222222333222222224422222222222",
    "222222222333222222224422222222222",
    "222222222233222222223322222222222",
    "222222222233222222223322222222222",
    "233333333333222222223322222222222",
    "233333333333222222223322222222222",
    "233323333332222222223333333333332",
    "222222222222222222223333333333332",
    "222222222222222222222222222222332",
    "222222222222222222222222222222222",
    "222222222222222222222222222222222",
    "222222222222222222222222333333333",
    "222222222222222222223333333333333",
    "333333333333322222223333323322332",
    "333333333333332222233322222222222",
    "222222222223332222233322222222222",
    "222222222222332222233222222222222",
    "222222222222332222233222222222222",
    "222222222222332222233222222222222",
    "222222222222332222233222222222222",
    "222222222222332222233222222222222",
    "222222222222332222233222222222222",
    "222222222222332222244222222222222",
    "222222222222332222244222222222222",
    "222222222222332222244222222222222",
    "222222222222332222244222222222222"
  ],
  "textures": [
    "222222222222222222222222222222222",
    "222222222222222222222222222222222",
    "222222222222222222222222222222222",
    "222222222222222222222222222222222",
    "222222222222222222222222222222222",
    "222222222222222222222222222222222",
    "222222222222222222222222222222222",
    "222222222222222222222222222222222",
    "222222222222222222222222222222222",
    "222222222222222222222222222222222",
    "222222222222222222222222222222222",
    "222222222222222222222222222222222",
    "222222222222222222222222222222222",
    "222222222222222222222222222222222",
    "222222222222222222222222222222222",
    "222222222222222222222222222222222",
    "222222222222222222222222222222222",
    "222222222222222222222222222222222",
    "222222222222222222222222222222222",
    "222222222222222222222222222222222",
    "222222222222222222222222222222222",
    "222222222222222222222222222222222",
    "222222222222222222222222222222222",
    "222222222222222222222222222222222",
    "222222222222222222222222222222222",
    "222222222222222222222222222222222",
    "222222222222222222222222222222222",
    "222222222222222222222222222222222",
    "222222222222222222222222222222222",
    "222222222222222222222222222222222",
    "222222222222222222222222222222222",
    "222222222222222222222222222222222",
    "222222222222222222222222222222222"
  ],
  "flags": [
    ".................................",
    ".................................",
    ".................................",
    ".................................",
    ".................................",
    ".................................",
    ".................................",
    ".................................",
    ".................................",
    ".................................",
    ".................................",
    ".................................",
    ".................................",
    ".................................",
    ".................................",
    ".................................",
    ".................................",
    ".................................",
    ".................................",
    ".................................",
    ".................................",
    ".................................",
    ".................................",
    ".................................",
    ".................................",
    ".................................",
    ".................................",
    ".................................",
    ".................................",
    ".................................",
    ".................................",
    ".................................",
    "................................."
  ],
  "doodads": [

  ],
  "camps": [
    {"x":25,"z":1737,"units":["ghoul","ghoul"]}
  ],
  "spawns": [
    {"x":-138,"z":-29},
    {"x":-88,"z":-29},
    {"x":-24,"z":-27},
    {"x":40,"z":-24}
  ],
  "runes": [

  ],
  "fountains": [

  ],
  "shops": [
    {"x":-226,"z":-231}
  ],
  "castles": [
    {"x":-51,"z":-235}
  ]
}
