{
  "format": "archer-map",
  "version": 2,
  "name": "glade",
  "tilesX": 24,
  "tilesZ": 24,
  "layers": [
    "2222222222222222333333333",
    "2222222222222222333333333",
    "2222222222222222333333333",
    "2222222222222222333333333",
    "2222222222222222333333333",
    "2222222222222222333333333",
    "2222222222222222333333333",
    "2222222222222222333333333",
    "2222222222222222333333333",
    "2222222222222222222222222",
    "2222222222222222222222222",
    "2222222222222222222222222",
    "2222222222222222222222222",
    "2222222222222222222222222",
    "2222222222222222222222222",
    "2222222222222222222222222",
    "2222222222222222222222222",
    "2222222222222222222222222",
    "2222222222222222222222222",
    "2222222222222222222222222",
    "2222222222222222222222222",
    "2222222222222222222222222",
    "2222222222222222222222222",
    "2222222222222222222222222",
    "2222222222222222222222222"
  ],
  "textures": [
    "2222222222222222666666666",
    "2222222222222222666666666",
    "2222222222222222666666666",
    "2222222222222222666666666",
    "2222222222222222666666666",
    "2222222222222222666666666",
    "2222222222222222666666666",
    "2222222222222222666666666",
    "2222222222222222660006666",
    "2222222222222222220002222",
    "2222222222222222222222222",
    "2222222222222222222222222",
    "2222222222222222222222222",
    "2222222222222222222222222",
    "2222222222222222222222222",
    "2222222222222222222222222",
    "2222222222222222222222222",
    "2222222222222222222222222",
    "2221111222222222222222222",
    "2221111222222222222222222",
    "2221111222222222222222222",
    "2221111222222222222222222",
    "2222222222222222222222222",
    "2222222222222222222222222",
    "2222222222222222222222222"
  ],
  "flags": [
    ".........................",
    ".........................",
    ".........................",
    ".........................",
    ".........................",
    ".........................",
    ".........................",
    ".........................",
    "...................r.....",
    "...................r.....",
    ".........................",
    ".........................",
    ".........................",
    ".........................",
    ".........................",
    ".........................",
    ".........................",
    ".........................",
    "...wwww..................",
    "...wwww..................",
    "...wwww..................",
    "...wwww..................",
    ".........................",
    ".........................",
    "........................."
  ],
  "doodads": [
    ["treeGreen",-1150,-350,10,100],
    ["treeGreen",-1190,-220,95,100],
    ["treeDark",-1120,-90,200,100],
    ["treeGreen",-1180,40,310,100],
    ["treeDark",-1130,170,45,100],
    ["treeTeal",-150,-700,15,110],
    ["treeTeal",-40,-760,120,100],
    ["treeGreen",60,-690,250,90],
    ["treeDark",-90,-600,330,100],
    ["treeGreen",700,500,60,100],
    ["treeDark",830,620,140,120],
    ["rock",350,-150,40,100],
    ["rock",-500,650,75,120],
    ["bush",150,350,0,100],
    ["bush",-700,-500,90,100],
    ["flower",-950,900,0,100],
    ["mushroom",900,-300,0,100]
  ],
  "camps": [
    {"x":-900,"z":-900,"units":["dragon"]},
    {"x":1050,"z":150,"units":["ghoul","ghoul"]},
    {"x":1000,"z":-1000,"units":["ghoul","dragon"]}
  ],
  "spawns": [
    {"x":-600,"z":1200},
    {"x":600,"z":1200}
  ],
  "runes": []
}
